0 0 0 0 0 0 0 0 0 0 0 0 0 0 0 4 4 4 3 3 4 4 4 0 0 0 0 0 0 0 0 0 0 0 0 0 0 0 0 0 0
0 0 0 0 0 0 0 0 0 0 0 0 0 0 0 4 4 4 3 3 4 4 4 0 0 0 0 0 0 0 0 0 0 0 0 0 0 0 0 0 0
0 0 0 0 0 0 0 1 1 1 1 1 0 0 0 4 4 4 3 3 4 4 4 0 0 0 0 0 0 0 0 0 0 0 0 0 0 0 0 0 0
0 0 0 1 1 1 1 1 0 0 0 0 0 0 0 4 4 4 3 3 4 4 4 0 0 0 0 0 0 0 0 0 0 0 0 0 0 0 0 0 0
0 0 0 0 1 0 0 0 0 0 1 1 0 0 0 4 4 4 3 3 4 4 4 0 0 0 0 0 0 0 0 0 0 0 0 0 0 0 0 0 0
0 0 0 1 1 0 0 0 0 0 1 0 0 0 0 4 4 4 3 3 4 4 4 0 0 0 0 0 0 0 0 0 0 0 0 0 0 0 0 0 0
0 0 0 1 0 0 0 0 0 1 0 0 0 0 0 4 4 4 3 3 4 4 4 0 0 0 0 0 0 0 0 0 0 0 0 0 0 0 0 0 0
0 0 0 1 0 0 0 0 1 1 0 0 0 0 0 4 4 4 3 3 4 4 4 0 0 0 0 0 0 0 0 0 0 0 0 0 0 0 0 0 0
0 0 0 1 0 0 0 1 0 0 0 0 0 0 0 4 4 4 3 3 4 4 4 0 0 0 0 0 0 0 0 0 0 0 0 0 0 0 0 0 0
0 0 0 1 1 1 1 1 0 0 0 0 0 0 0 4 4 4 3 3 4 4 4 0 0 0 0 0 0 0 0 0 0 0 0 0 0 0 0 0 0
0 0 0 0 0 0 0 0 0 0 0 0 0 0 0 4 4 4 3 3 4 4 4 0 0 0 0 0 0 0 0 0 0 0 0 0 0 0 0 0 0
0 0 0 0 0 0 0 0 0 0 0 0 0 0 0 4 4 4 3 3 4 4 4 0 0 0 0 0 0 0 0 0 0 0 0 0 0 0 0 0 0
0 0 0 0 0 0 0 0 0 0 0 0 0 0 0 0 4 4 3 3 4 4 0 0 0 0 0 0 0 0 0 0 0 0 0 0 0 0 0 0 0
0 0 0 0 0 0 0 0 0 0 0 0 0 0 0 0 4 4 3 3 4 4 0 0 0 0 0 0 0 0 0 0 0 0 0 0 0 0 0 0 0
0 0 0 0 0 0 0 0 0 0 0 0 0 0 0 0 0 4 3 3 4 0 0 0 0 0 0 0 0 0 0 0 0 0 0 0 0 0 0 0 0
0 0 0 0 0 0 0 0 0 0 0 0 0 0 0 0 0 4 3 3 4 0 0 0 0 0 0 0 0 0 0 0 0 0 0 0 0 0 0 0 0
0 0 0 0 0 0 0 0 0 0 0 0 0 0 0 0 0 0 5 5 0 0 0 0 0 0 0 0 0 0 0 0 0 0 0 0 0 0 0 0 0
0 0 0 0 0 0 0 0 0 0 0 0 0 0 0 0 0 0 0 0 0 0 0 0 0 0 0 0 0 0 0 0 0 0 0 0 0 0 0 0 0
0 0 0 0 0 0 0 0 0 0 0 0 0 0 0 0 4 4 3 3 4 0 0 0 0 0 0 0 0 0 0 0 0 0 0 0 0 0 0 0 0
1 1 4 4 4 4 4 4 4 4 4 4 4 4 4 1 1 4 3 3 4 0 0 0 0 0 0 0 0 0 0 0 0 0 0 0 0 0 0 0 0
1 1 4 0 0 0 0 0 0 0 0 0 0 0 4 1 0 4 3 3 4 4 0 0 0 0 0 0 0 0 0 0 0 0 0 0 0 0 4 4 4
1 1 4 0 7 0 0 0 7 0 0 0 7 0 4 1 1 4 3 3 4 4 0 0 0 0 0 0 0 0 0 0 0 0 0 0 0 0 4 4 4
1 1 4 0 0 0 0 0 0 0 0 0 0 0 4 1 1 4 3 3 4 4 4 0 0 0 0 0 0 0 0 0 0 0 0 0 0 0 4 4 4
1 1 4 0 0 0 0 0 0 0 0 0 0 0 4 1 1 4 3 3 4 4 4 0 0 0 0 0 0 0 0 0 0 0 0 0 0 0 4 4 4
1 1 4 4 4 4 4 4 4 4 4 4 4 4 4 1 1 4 3 3 4 4 4 0 0 0 0 0 0 0 0 0 0 0 0 0 0 0 4 4 4
1 1 4 0 0 0 0 0 0 0 0 0 0 0 4 0 0 4 3 3 4 4 4 0 0 0 0 0 0 0 0 0 0 0 0 0 0 0 4 4 4
1 1 4 0 0 0 0 0 0 0 0 0 0 0 4 1 1 4 3 3 4 4 4 0 0 0 0 0 0 0 0 0 0 0 0 0 0 0 4 4 4
1 1 4 0 7 0 0 0 7 0 0 0 7 0 4 1 1 4 3 3 4 4 4 0 0 0 0 0 0 0 0 0 0 0 0 0 0 0 4 4 4
1 1 4 0 0 0 0 0 0 0 0 0 0 0 4 1 1 4 3 3 4 4 4 0 0 0 0 0 0 0 0 0 0 0 0 0 0 0 1 0 0
1 1 4 4 4 4 4 4 4 4 4 4 4 4 4 1 1 4 3 3 4 4 4 0 0 0 0 0 0 0 0 0 0 0 0 0 0 0 1 0 0
1 1 1 1 1 1 1 1 1 1 1 1 1 1 1 1 1 4 3 3 4 4 4 0 0 0 0 0 0 0 0 0 0 0 0 0 0 0 1 0 6
